5
13101
10101
10101
10101
10021